Columns: 41
Rows: 23
34343434343434343434343434343434343434343				
56565656565656565656565656565656565656565
34000000000000000000000000000000000000034
56000000000000000011111111100000000000056
34000000000000000000111111100000000000034
56000000000000000000000000000000000000056
34000034000000343434343400000000000000034
56000056000000565656565600000000000000056
34000000000000340000000000000000000000034
56000000000000560000000000000000000000056
34000000000000000000000000000000000000034
56000000000000000000000000000000000000056
34000000000000000000000000000000000000034
56000000000000000000000000000000000000056
34000000000000000000000000000000000000034
56000000000000000000000000000000000000056
34000000000000000000000000000000000000034
56000000000000000000000000000000000000056
34000000000000000000000000000000000000034
56000000000000000000000000000000000000056
34000000000000000000000000000000000000034
56000000000000000000000000000000000000056
34343434343434343434343434343434343434343
56565656565656565656565656565656565656565

